& : dan
trbuka : terbuka
dipke : dipake
kmbali : kembali
lyar : layar
tlong : tolong
prbharui : perbaharui
brmnfaat : bermanfaat
dmnapin : dimanapun
kpnpun : kapanpun
prbaiki : perbaiki
wslm : wassalam
yak : ya
nggk : tidak
وسلام : wassalam
yaa : ya
brenti : berhenti
kluar : keluar
oarang : orang
yaaa : ya
ngunduh : mengunduh
aamiin : amin
dirobah : dirubah
bngt : banget
lnjut : lanjut
hlmn : halaman
min : admin
tlg : tolong
krena : karena
ngak : tidak
mnitmit: menit
lgsung : langsung
alquraan : alquran
paedahnya : faedahnya
trakhir : terakhir
trpotong : terpotong
smpe : sampai
mlanjutkan : melanjutkan
stanby : standby
sja : saja
applikasi : aplikasi
yth : yang terhormat
aplikasix : aplikasinya
trkadang : terkadang
screenx : screennya
sngt : sangat
dengn: dengan
baccaan : bacaan
krna : karena
mna : mana
siiiiiiiiipp : sip
mkin : makin
yll : yang lalu
sd : sampai dengan
yea: yes
brpa : berapa
dibthkan : dibutuhkan
ngg : tidak
hlmn : halaman
brkutny : berikutnya
gmna : bagaimana
gmn : bagaimana